# convey the truth of a variable through the second floor

# FRONT
. . . . . . 1 1 1 1 . . . .
1 1 . 1 1 . . 1 . 1 . . . .

# SIDE
. 1 1 . . 0 0  0   0
1 0 0 . . 1 1 (2) (2)

# TOP
0 . 0 . 0 0 0 . 0 0 0 . 0 .
. 0 0 0 . 0 0 0 0 . 0 . 0 .
. . 0 0 0 0 0 0 0 0 0 0 0 0
0 0 0 . . 0 0 0 0 0 0 0 0 0
0 0 0 0 0 0 1 0 0 0 0 0 0 0
0 0 0 0 0 0 0 1 0 0 0 0 0 0
0 0 0 0 0 0 0 . . 0 0 0 0 0
0 0 0 0 0 0 . 0 0 . 0 0 0 0
0 0 0 0 0 0 0 0 1 1 0 0 0 0
